     '##:::::::'########:'##::::'##:'########:'##::::::::::'##::::'##:'########::
      ##::::::: ##.....:: ##:::: ##: ##.....:: ##:::::::::: ##:::: ##: ##.... ##:
      ##::::::: ##::::::: ##:::: ##: ##::::::: ##:::::::::: ##:::: ##: ##:::: ##:
      ##::::::: ######::: ##:::: ##: ######::: ##:::::::::: ##:::: ##: ########::
      ##::::::: ##...::::. ##:: ##:: ##...:::: ##:::::::::: ##:::: ##: ##.....:::
      ##::::::: ##::::::::. ## ##::: ##::::::: ##:::::::::: ##:::: ##: ##::::::::
      ########: ########:::. ###:::: ########: ########::::. #######:: ##::::::::
     ........::........:::::...:::::........::........::::::.......:::..:::::::::
